######################
#S# ##    ##   #######
# #   #              #
# # #   #######      #
#   #        #  #  # #
# ############     # #
#   # #        ####  #
# #   #    # #       #
###################G##